けっこん	Married
せっけん	Soap
がっき	Musical instrument
らっかさん	Parachute
せいねんがっぴ	Birth date
しっぱい	failure
ろっぷん	Six minutes
いっぷん	A while　/ one minute
こぎって	Check
あさって	The day after tomorrow
ねったい	Tropics
けっさき	Absence
はっせん	Eight thousand
いっさつ	One book
はっけん	Discovery
にっき	Diary
さっか	Writer
いっかい	first floor
ほっぺた	Cheeks
きっぷ	Tickets
きって	Stamp
ざっし	Magazine